TileSheet,img/TileSheets/TileSheet.png,16
0,0,0,0,0,0,0,0,0,0,0,0,0,0,243,243,0,0,0,0,0,0,
0,243,243,243,243,243,243,243,243,243,0,243,243,243,243,243,243,243,243,243,243,0,
0,243,243,243,243,243,243,243,243,243,0,243,243,243,243,243,243,243,243,243,243,0,
0,243,243,243,243,243,243,243,243,243,0,243,243,243,243,243,243,243,243,243,243,0,
0,243,243,243,243,243,243,243,243,243,0,243,243,243,243,243,243,243,243,243,243,0,
0,243,243,243,243,243,243,243,243,243,0,243,243,243,243,243,243,243,243,243,243,0,
0,243,243,243,243,243,243,243,243,243,0,243,243,243,243,243,243,243,243,243,243,0,
0,243,243,243,243,243,243,243,243,243,243,243,243,243,243,243,243,243,243,243,243,0,
0,243,243,243,243,243,243,243,243,243,243,243,243,243,243,243,243,243,243,243,243,0,
0,243,243,243,243,243,243,243,243,243,0,243,243,243,243,243,243,243,243,243,243,0,
0,243,243,243,243,243,243,243,243,243,0,243,243,243,243,243,243,243,243,243,243,0,
0,243,243,243,243,243,243,243,243,243,0,243,243,243,243,243,243,243,243,243,243,0,
0,243,243,243,243,243,243,243,243,243,0,243,243,243,243,243,243,243,243,243,243,0,
0,243,243,243,243,243,243,243,243,243,0,243,243,243,243,243,243,243,243,243,243,0,
0,243,243,243,243,243,243,243,243,243,0,243,243,243,243,243,243,243,243,243,243,0,
0,0,0,0,243,243,0,0,0,0,0,0,0,0,0,0,0,0,0,0,0,0
END LAYER
1025,1025,1025,1025,1025,1025,1025,1025,1025,1025,1025,1025,1025,1025,0,0,1025,1025,1025,1025,1025,1025,
1025,0,0,0,0,0,0,0,0,0,1025,0,0,0,0,0,0,0,0,0,0,1025,
1025,0,0,0,0,0,0,0,0,0,1025,0,0,0,0,0,0,0,0,0,0,1025,
1025,0,0,0,0,0,0,0,0,0,1025,0,0,3194,0,0,0,0,0,0,0,1025,
1025,0,0,0,0,0,0,0,0,0,1025,0,0,0,0,0,0,0,0,0,0,1025,
1025,0,0,0,0,0,0,0,0,0,1025,0,0,0,0,0,0,0,0,0,0,1025,
1025,0,0,0,0,0,0,0,0,0,1025,0,0,0,0,0,0,0,0,0,0,1025,
1025,0,0,0,0,0,0,0,0,0,0,0,0,0,0,0,0,0,0,0,0,1025,
1025,0,0,0,0,0,0,0,0,0,0,0,0,0,0,0,0,0,0,0,0,1025,
1025,0,0,0,0,0,0,0,0,0,1025,0,0,0,0,0,0,0,0,0,0,1025,
1025,0,0,3194,0,0,0,0,0,0,1025,0,0,0,0,0,0,0,0,0,0,1025,
1025,0,0,0,0,0,0,0,0,0,1025,0,0,0,0,0,0,0,0,0,0,1025,
1025,0,0,0,0,0,0,0,0,0,1025,0,0,0,0,0,0,0,0,0,0,1025,
1025,0,0,0,0,3194,0,0,0,0,1025,0,0,0,0,0,0,0,0,0,0,1025,
1025,0,0,0,0,0,0,0,0,0,1025,0,0,0,0,0,0,0,0,0,0,1025,
1025,1025,1025,1025,0,0,1025,1025,1025,1025,1025,1025,1025,1025,1025,1025,1025,1025,1025,1025,1025,1025
END LAYER
0,0,0,0,0,0,0,0,0,0,0,0,0,0,0,0,0,0,0,0,0,0,
0,0,0,0,0,0,0,0,0,0,0,0,0,0,0,0,0,0,0,0,0,0,
0,0,0,0,0,0,0,0,0,0,0,0,0,0,0,0,0,0,0,0,0,0,
0,0,0,0,0,0,0,0,0,0,0,0,0,0,0,0,0,0,0,0,0,0,
0,0,0,0,0,0,0,0,0,0,0,0,0,0,0,0,0,0,0,0,0,0,
0,0,0,0,0,0,0,0,0,0,0,0,0,0,0,0,0,0,0,0,0,0,
0,0,0,0,0,0,0,0,0,0,0,0,0,0,0,0,0,0,0,0,0,0,
0,0,0,0,0,0,0,0,0,0,0,0,0,0,0,0,0,0,0,0,0,0,
0,0,0,0,0,0,0,0,0,0,0,0,0,0,0,0,0,0,0,0,0,0,
0,0,0,0,0,0,0,0,0,0,0,0,0,0,0,0,0,0,0,0,0,0,
0,0,0,0,0,0,0,0,0,0,0,0,0,0,0,0,0,0,0,0,0,0,
0,0,0,0,0,0,0,0,0,0,0,0,0,0,0,0,0,0,0,0,0,0,
0,0,0,0,0,0,0,0,0,0,0,0,0,0,0,0,0,0,0,0,0,0,
0,0,0,0,0,0,0,0,0,0,0,0,0,0,0,0,0,0,0,0,0,0,
0,0,0,0,0,0,0,0,0,0,0,0,0,0,0,0,0,0,0,0,0,0,
0,0,0,0,0,0,0,0,0,0,0,0,0,0,0,0,0,0,0,0,0,0
END LAYER
END MAP
START PROPERTIES
Player,45,150
Enemy,SnakeEnemy,50,50
Enemy,SnakeEnemy,90,90
Enemy,SnakeEnemy,80,80
Portal,40,160,overWorld,55,25
Portal,50,160,overWorld,55,25
Portal,160,0,shadowDungeon,200,370
Portal,170,0,shadowDungeon,200,370
Puzzle,Block,40,75,10,10
Puzzle,Block,60,95,10,10
Puzzle,Block,40,95,10,10
Puzzle,Block,60,75,10,10
Puzzle,Door,105,80,17.5,17.5
Puzzle,PressurePoint,20,135,7.5,7.5,0
Puzzle,PressurePoint,20,25,7.5,7.5,0
Puzzle,PressurePoint,90,135,7.5,7.5,0
Puzzle,PressurePoint,90,25,7.5,7.5,0
PressurePointCollection,0
Puzzle,ResetBlocks,20,95,7.5,7.5
Puzzle,Door,150,10,17.5,17.5
Puzzle,Block,115,145,7.5,7.5
Puzzle,Block,205,145,7.5,7.5
Puzzle,Block,135,125,7.5,7.5
Puzzle,Block,145,125,7.5,7.5
Puzzle,Block,155,125,7.5,7.5
Puzzle,Block,175,125,7.5,7.5
Puzzle,Block,175,135,7.5,7.5
Puzzle,Block,165,135,7.5,7.5
Puzzle,Block,185,125,7.5,7.5
Puzzle,Block,165,115,7.5,7.5
Puzzle,Block,155,105,7.5,7.5
Puzzle,Chest,125,135,10,10,HealthPotion
Puzzle,Chest,195,135,10,10,SpeedPotion
Puzzle,Chest,145,115,10,10,DamagePotion
Puzzle,Chest,175,115,10,10,Key
Sign,35,105,Step on the switch to reset the blocks!,250
Sign,55,135,Push the blocks to the 4 corner switches to unlock the door!,250
Sign,135,35,Get a key from the chest to unlock the door!,250
END PROPERTIES