TileSheet,img/TileSheets/TileSheet.png,16
0,0,0,0,0,0,0,0,0,0,0,0,0,0,0,0,0,0,0,0,0,0,0,0,0,0,0,0,0,0,0,0,0,0,0,0,0,0,0,0,
0,548,548,548,548,548,548,0,548,548,548,548,548,548,548,548,548,548,548,548,548,548,548,548,548,548,548,548,548,548,548,548,0,548,548,548,548,548,548,0,
0,548,548,548,548,548,548,0,548,2443,2443,548,548,2443,2443,548,548,2443,2443,548,548,2443,2443,548,548,2443,2443,548,548,2443,2443,548,0,548,548,548,548,548,548,0,
0,548,548,548,548,548,548,0,548,2443,2443,548,548,2443,2443,548,548,2443,2443,548,548,2443,2443,548,548,2443,2443,548,548,2443,2443,548,0,548,548,548,548,548,548,0,
0,548,548,548,548,548,548,0,548,548,548,548,548,548,548,548,548,548,548,548,548,548,548,548,548,548,548,548,548,548,548,548,0,548,548,548,548,548,548,0,
0,548,548,548,548,548,548,0,548,548,548,548,548,548,548,548,548,548,548,548,548,548,548,548,548,548,548,548,548,548,548,548,0,548,548,548,548,548,548,0,
0,548,548,548,548,548,548,0,548,548,548,548,548,548,548,548,548,548,548,548,548,548,548,548,548,548,548,548,548,548,548,548,0,548,548,548,548,548,548,0,
0,548,548,548,548,548,548,0,548,548,548,548,548,548,548,548,548,548,548,548,548,548,548,548,548,548,548,548,548,548,548,548,0,548,548,548,548,548,548,0,
0,548,548,548,548,548,548,0,548,548,548,548,548,548,548,548,548,548,548,548,548,548,548,548,548,548,548,548,548,548,548,548,0,548,548,548,548,548,548,0,
0,548,548,548,548,548,548,0,548,548,548,548,548,548,548,548,548,548,548,548,548,548,548,548,548,548,548,548,548,548,548,548,0,548,548,548,548,548,548,0,
0,548,548,548,548,548,548,0,548,548,548,548,548,548,548,548,548,548,548,548,548,548,548,548,548,548,548,548,548,548,548,548,0,548,548,548,548,548,548,0,
0,548,548,548,548,548,548,0,548,548,548,548,548,548,548,548,548,548,548,548,548,548,548,548,548,548,548,548,548,548,548,548,0,548,548,548,548,548,548,0,
0,548,548,548,548,548,548,0,548,548,548,548,548,548,548,548,548,548,548,548,548,548,548,548,548,548,548,548,548,548,548,548,0,548,548,548,548,548,548,0,
0,548,548,548,548,548,548,0,548,548,548,548,548,548,548,548,548,548,548,548,548,548,548,548,548,548,548,548,548,548,548,548,0,548,548,548,548,548,548,0,
0,0,0,548,548,0,0,0,0,0,0,0,0,0,0,0,0,0,548,548,548,548,0,0,0,0,0,0,0,0,0,0,0,0,0,548,548,0,0,0,
0,548,548,548,548,548,548,548,548,548,548,548,548,548,548,548,548,548,548,548,548,548,548,548,548,548,548,548,548,548,548,548,548,548,548,548,548,548,548,0,
0,548,548,548,548,548,548,548,548,548,548,548,548,548,548,548,548,548,548,548,548,548,548,548,548,548,548,548,548,548,548,548,548,548,548,548,548,548,548,0,
0,0,0,0,0,0,0,0,0,0,0,0,0,0,0,0,0,0,0,548,548,0,0,0,0,0,0,0,0,0,0,0,0,0,0,0,0,0,0,0,
0,548,548,548,548,548,548,0,3456,3456,3456,3456,3456,3456,3456,3456,3456,3456,3456,3456,3456,3456,3456,3456,3456,3456,3456,3456,3456,3456,3456,3456,0,548,548,548,548,548,548,0,
0,548,548,548,548,548,548,0,3456,3456,3456,3456,3456,3456,3456,3456,3456,3456,3456,3456,3456,3456,3456,3456,3456,3456,3456,3456,3456,3456,3456,3456,0,548,548,548,548,548,548,0,
0,548,548,548,548,548,548,0,3456,3456,3456,3456,3456,3456,3456,3456,3456,3456,3456,3456,3456,3456,3456,3456,3456,3456,3456,3456,3456,3456,3456,3456,0,548,548,548,548,548,548,0,
0,548,548,548,548,548,548,0,3456,3456,3456,3456,3456,3456,3456,3456,3456,3456,3456,3456,3456,3456,3456,3456,3456,3456,3456,3456,3456,3456,3456,3456,0,548,548,548,548,548,548,0,
0,548,548,548,548,548,548,0,3456,3456,3456,3456,3456,3456,3456,3456,3456,3456,3456,3456,3456,3456,3456,3456,3456,3456,3456,3456,3456,3456,3456,3456,0,548,548,548,548,548,548,0,
0,548,548,548,548,548,548,0,3456,3456,3456,3456,3456,3456,3456,3456,3456,3456,3456,3456,3456,3456,3456,3456,3456,3456,3456,3456,3456,3456,3456,3456,0,548,548,548,548,548,548,0,
0,548,548,548,548,548,548,0,3456,3456,3456,3456,3456,3456,3456,3456,3456,3456,3456,3456,3456,3456,3456,3456,3456,3456,3456,3456,3456,3456,3456,3456,0,548,548,548,548,548,548,0,
0,548,548,548,548,548,548,0,3456,3456,3456,3456,3456,3456,3456,3456,3456,3456,3456,3456,3456,3456,3456,3456,3456,3456,3456,3456,3456,3456,3456,3456,0,548,548,548,548,548,548,0,
0,548,548,548,548,548,548,0,3456,3456,3456,3456,3456,3456,3456,3456,3456,3456,3456,3456,3456,3456,3456,3456,3456,3456,3456,3456,3456,3456,3456,3456,0,548,548,548,548,548,548,0,
0,548,548,548,548,548,548,0,3456,3456,3456,3456,3456,3456,3456,3456,3456,3456,3456,3456,3456,3456,3456,3456,3456,3456,3456,3456,3456,3456,3456,3456,0,548,548,548,548,548,548,0,
0,548,548,548,548,548,548,0,3456,3456,3456,3456,3456,3456,3456,3456,3456,3456,3456,3456,3456,3456,3456,3456,3456,3456,3456,3456,3456,3456,3456,3456,0,548,548,548,548,548,548,0,
0,548,548,548,548,548,548,0,3456,3456,3456,3456,3456,3456,3456,3456,3456,3456,3456,3456,3456,3456,3456,3456,3456,3456,3456,3456,3456,3456,3456,3456,0,548,548,548,548,548,548,0,
0,548,548,548,548,548,548,0,3456,3456,3456,3456,3456,3456,3456,3456,3456,3456,3456,3456,3456,3456,3456,3456,3456,3456,3456,3456,3456,3456,3456,3456,0,548,548,548,548,548,548,0,
0,548,548,548,548,548,548,0,0,0,0,0,0,0,0,0,0,0,0,548,548,0,0,0,0,0,0,0,0,0,0,0,0,548,548,548,548,548,548,0,
0,548,548,548,548,548,548,548,548,548,548,548,548,548,548,548,548,548,548,548,548,548,548,548,548,548,548,548,548,548,548,548,548,548,548,548,548,548,548,0,
0,548,548,548,548,548,548,548,548,548,548,548,548,548,548,548,548,548,548,548,548,548,548,548,548,548,548,548,548,548,548,548,548,548,548,548,548,548,548,0,
0,548,548,548,548,548,548,548,548,548,548,548,548,548,548,548,0,0,0,548,548,0,0,0,548,548,548,548,548,548,548,548,548,548,548,548,548,548,548,0,
0,548,548,548,548,548,548,548,548,548,548,548,548,548,548,548,0,548,548,548,548,548,548,0,548,548,548,548,548,548,548,548,548,548,548,548,548,548,548,0,
0,548,548,548,548,548,548,548,548,548,548,548,548,548,548,548,0,548,548,548,548,548,548,0,548,548,548,548,548,548,548,548,548,548,548,548,548,548,548,0,
0,548,548,548,548,548,548,548,548,548,548,548,548,548,548,548,0,548,548,548,548,548,548,0,548,548,548,548,548,548,548,548,548,548,548,548,548,548,548,0,
0,548,548,548,548,548,548,548,548,548,548,548,548,548,548,548,0,548,548,548,548,548,548,0,548,548,548,548,548,548,548,548,548,548,548,548,548,548,548,0,
0,0,0,0,0,0,0,0,0,0,0,0,0,0,0,0,0,0,0,548,548,0,0,0,0,0,0,0,0,0,0,0,0,0,0,0,0,0,0,0
END LAYER
75,75,75,75,75,75,75,75,75,75,75,75,75,75,75,75,75,75,75,75,75,75,75,75,75,75,75,75,75,75,75,75,75,75,75,75,75,75,75,75,
75,0,0,0,0,0,0,75,0,0,0,0,0,0,0,0,0,0,0,0,0,0,0,0,0,0,0,0,0,0,0,0,75,0,0,0,0,0,0,75,
75,0,0,0,0,0,0,75,0,0,0,0,0,0,0,0,0,0,0,0,0,0,0,0,0,0,0,0,0,0,0,0,75,0,0,0,0,0,0,75,
75,0,0,0,0,0,0,75,0,0,0,0,0,0,0,0,0,0,0,0,0,0,0,0,0,0,0,0,0,0,0,0,75,0,0,0,0,0,0,75,
75,0,0,0,0,0,0,75,0,0,0,0,0,0,0,0,0,0,0,0,0,0,0,0,0,0,0,0,0,0,0,0,75,0,0,0,0,0,0,75,
75,0,0,0,0,0,0,75,0,0,0,0,0,0,0,0,0,0,0,0,0,0,0,0,0,0,0,0,0,0,0,0,75,0,0,0,0,0,0,75,
75,0,0,0,0,0,0,75,0,0,0,0,0,0,0,0,0,0,0,0,0,0,0,0,0,0,0,0,0,0,0,0,75,0,0,0,0,0,0,75,
75,0,0,0,0,0,0,75,0,0,0,0,0,0,0,0,0,0,0,0,0,0,0,0,0,0,0,0,0,0,0,0,75,0,0,0,0,0,0,75,
75,0,0,0,0,0,0,75,0,0,0,0,0,0,0,0,0,0,0,0,0,0,0,0,0,0,0,0,0,0,0,0,75,0,0,0,0,0,0,75,
75,0,0,0,0,0,0,75,0,0,0,0,0,0,0,0,0,0,0,0,0,0,0,0,0,0,0,0,0,0,0,0,75,0,0,0,0,0,0,75,
75,0,0,0,0,0,0,75,0,0,0,0,0,0,0,0,0,0,0,0,0,0,0,0,0,0,0,0,0,0,0,0,75,0,0,0,0,0,0,75,
75,0,0,0,0,0,0,75,0,0,0,0,0,0,0,0,0,0,0,0,0,0,0,0,0,0,0,0,0,0,0,0,75,0,0,0,0,0,0,75,
75,0,0,0,0,0,0,75,0,0,0,0,0,0,0,0,0,0,0,0,0,0,0,0,0,0,0,0,0,0,0,0,75,0,0,0,0,0,0,75,
75,0,0,0,0,0,0,75,0,0,0,0,0,0,0,0,0,0,0,0,0,0,0,0,0,0,0,0,0,0,0,0,75,0,0,0,0,0,0,75,
75,75,75,0,0,75,75,75,75,75,75,75,75,75,75,75,75,75,0,0,0,0,75,75,75,75,75,75,75,75,75,75,75,75,75,0,0,75,75,75,
75,0,0,0,0,0,0,0,0,0,0,0,0,0,0,0,0,0,0,0,0,0,0,0,0,0,0,0,0,0,0,0,0,0,0,0,0,0,0,75,
75,0,0,0,0,0,0,0,0,0,0,0,0,0,0,0,0,0,0,0,0,0,0,0,0,0,0,0,0,0,0,0,0,0,0,0,0,0,0,75,
75,75,75,75,75,75,75,75,75,75,75,75,75,75,75,75,75,75,75,0,0,75,75,75,75,75,75,75,75,75,75,75,75,75,75,75,75,75,75,75,
75,0,0,0,0,0,0,75,0,0,0,0,0,0,0,0,2436,0,0,0,0,0,0,2436,0,0,0,0,2436,0,0,0,75,0,0,0,0,0,0,75,
75,0,0,0,0,0,0,75,0,0,0,0,0,0,0,0,0,0,0,0,2436,0,0,0,0,0,0,0,0,2436,0,0,75,0,0,0,0,0,0,75,
75,0,0,0,0,0,0,75,2436,0,0,0,0,0,0,0,0,0,0,0,0,0,0,0,0,0,0,0,0,0,0,2436,75,0,0,0,0,0,0,75,
75,0,0,0,0,0,0,75,0,0,2436,0,0,0,0,0,0,0,0,2436,2436,0,0,0,0,0,0,0,0,0,0,0,75,0,0,0,0,0,0,75,
75,0,0,0,0,0,0,75,0,2436,0,0,0,0,0,0,0,0,0,0,0,0,0,0,2436,0,0,0,0,0,0,0,75,0,0,0,0,0,0,75,
75,0,0,0,0,0,0,75,0,0,0,0,0,0,0,0,0,0,0,0,0,0,0,0,0,0,0,0,0,0,0,0,75,0,0,0,0,0,0,75,
75,0,0,0,0,0,0,75,0,0,0,0,0,0,0,0,0,0,0,0,0,0,0,0,0,0,0,0,0,0,0,0,75,0,0,0,0,0,0,75,
75,0,0,0,0,0,0,75,0,0,0,0,0,0,2436,0,0,0,0,0,0,0,0,0,0,0,0,2436,0,2436,0,0,75,0,0,0,0,0,0,75,
75,0,0,0,0,0,0,75,0,0,0,0,0,0,0,2436,0,0,0,0,0,2436,0,0,0,0,0,0,0,0,2436,0,75,0,0,0,0,0,0,75,
75,0,0,0,0,0,0,75,2436,0,0,0,0,0,0,0,0,0,0,0,0,0,0,0,0,0,0,0,0,0,0,0,75,0,0,0,0,0,0,75,
75,0,0,0,0,0,0,75,0,0,2436,0,0,0,0,0,0,0,0,0,0,0,2436,0,0,0,0,0,2436,0,0,0,75,0,0,0,0,0,0,75,
75,0,0,0,0,0,0,75,0,0,0,0,0,0,0,0,0,0,0,0,0,0,0,2436,0,0,0,0,0,0,0,0,75,0,0,0,0,0,0,75,
75,0,0,0,0,0,0,75,0,0,0,0,0,0,0,0,0,0,2436,0,0,0,0,0,0,0,0,0,0,0,0,0,75,0,0,0,0,0,0,75,
75,0,0,0,0,0,0,75,75,75,75,75,75,75,75,75,75,75,75,0,0,75,75,75,75,75,75,75,75,75,75,75,75,0,0,0,0,0,0,75,
75,0,0,0,0,0,0,0,0,0,0,0,0,0,0,0,0,0,0,0,0,0,0,0,0,0,0,0,0,0,0,0,0,0,0,0,0,0,0,75,
75,0,0,0,0,0,0,0,0,0,0,0,0,0,0,0,0,0,0,0,0,0,0,0,0,0,0,0,0,0,0,0,0,0,0,0,0,0,0,75,
75,0,0,0,0,0,0,0,0,0,0,0,0,0,0,0,75,75,75,0,0,75,75,75,0,0,0,0,0,0,0,0,0,0,0,0,0,0,0,75,
75,0,0,0,0,0,0,0,0,0,0,0,0,0,0,0,75,0,0,0,0,0,0,75,0,0,0,0,0,0,0,0,0,0,0,0,0,0,0,75,
75,0,0,0,0,0,0,0,0,0,0,0,0,0,0,0,75,0,0,0,0,0,0,75,0,0,0,0,0,0,0,0,0,0,0,0,0,0,0,75,
75,0,0,0,0,0,0,0,0,0,0,0,0,0,0,0,75,0,0,0,0,0,0,75,0,0,0,0,0,0,0,0,0,0,0,0,0,0,0,75,
75,0,0,0,0,0,0,0,0,0,0,0,0,0,0,0,75,0,0,0,0,0,0,75,0,0,0,0,0,0,0,0,0,0,0,0,0,0,0,75,
75,75,75,75,75,75,75,75,75,75,75,75,75,75,75,75,75,75,75,0,0,75,75,75,75,75,75,75,75,75,75,75,75,75,75,75,75,75,75,75
END LAYER
0,0,0,0,0,0,0,0,0,0,0,0,0,0,0,0,0,0,0,0,0,0,0,0,0,0,0,0,0,0,0,0,0,0,0,0,0,0,0,0,
0,0,0,0,0,0,0,0,0,0,0,0,0,0,0,0,0,0,0,0,0,0,0,0,0,0,0,0,0,0,0,0,0,0,0,0,0,0,0,0,
0,0,0,0,0,0,0,0,0,0,0,0,0,0,0,0,0,0,0,0,0,0,0,0,0,0,0,0,0,0,0,0,0,0,0,0,0,0,0,0,
0,0,0,0,0,0,0,0,0,0,0,0,0,0,0,0,0,0,0,0,0,0,0,0,0,0,0,0,0,0,0,0,0,0,0,0,0,0,0,0,
0,0,0,0,0,0,0,0,0,0,0,0,0,0,0,0,0,0,0,0,0,0,0,0,0,0,0,0,0,0,0,0,0,0,0,0,0,0,0,0,
0,0,0,0,0,0,0,0,0,0,0,0,0,0,0,0,0,0,0,0,0,0,0,0,0,0,0,0,0,0,0,0,0,0,0,0,0,0,0,0,
0,0,0,0,0,0,0,0,0,0,0,0,0,0,0,0,0,0,0,0,0,0,0,0,0,0,0,0,0,0,0,0,0,0,0,0,0,0,0,0,
0,0,0,0,0,0,0,0,0,0,0,0,0,0,0,0,0,0,0,0,0,0,0,0,0,0,0,0,0,0,0,0,0,0,0,0,0,0,0,0,
0,0,0,0,0,0,0,0,0,0,0,0,0,0,0,0,0,0,0,0,0,0,0,0,0,0,0,0,0,0,0,0,0,0,0,0,0,0,0,0,
0,0,0,0,0,0,0,0,0,0,0,0,0,0,0,0,0,0,0,0,0,0,0,0,0,0,0,0,0,0,0,0,0,0,0,0,0,0,0,0,
0,0,0,0,0,0,0,0,0,0,0,0,0,0,0,0,0,0,0,0,0,0,0,0,0,0,0,0,0,0,0,0,0,0,0,0,0,0,0,0,
0,0,0,0,0,0,0,0,0,0,0,0,0,0,0,0,0,0,0,0,0,0,0,0,0,0,0,0,0,0,0,0,0,0,0,0,0,0,0,0,
0,0,0,0,0,0,0,0,0,0,0,0,0,0,0,0,0,0,0,0,0,0,0,0,0,0,0,0,0,0,0,0,0,0,0,0,0,0,0,0,
0,0,0,0,0,0,0,0,0,0,0,0,0,0,0,0,0,0,0,0,0,0,0,0,0,0,0,0,0,0,0,0,0,0,0,0,0,0,0,0,
0,0,0,0,0,0,0,0,0,0,0,0,0,0,0,0,0,0,0,0,0,0,0,3194,0,0,0,0,0,0,0,0,0,0,0,0,0,0,0,0,
0,0,0,0,0,0,0,0,0,0,0,0,0,0,0,0,0,0,0,0,0,0,0,0,0,0,0,0,0,0,0,0,0,0,0,0,0,0,0,0,
0,0,0,0,0,0,0,0,0,0,0,0,0,0,0,0,0,0,0,0,0,0,0,0,0,0,0,0,0,0,0,0,0,0,0,0,0,0,0,0,
0,0,0,0,0,0,0,0,0,0,0,0,0,0,0,0,2376,0,0,0,0,0,0,2376,0,0,0,0,2376,0,0,0,0,0,0,0,0,0,0,0,
0,0,0,0,0,0,0,0,0,0,0,0,0,0,0,0,0,0,0,0,2376,0,0,0,0,0,0,0,0,2376,0,0,0,0,0,0,0,0,0,0,
0,0,0,0,0,0,0,0,2376,0,0,0,0,0,0,0,0,0,0,0,0,0,0,0,0,0,0,0,0,0,0,2376,0,0,0,0,0,0,0,0,
0,0,0,0,0,0,0,0,0,0,2376,0,0,0,0,0,0,0,0,2376,2376,0,0,0,0,0,0,0,0,0,0,0,0,0,0,0,0,0,0,0,
0,0,0,0,0,0,0,0,0,2376,0,0,0,0,0,0,0,0,0,0,0,0,0,0,2376,0,0,0,0,0,0,0,0,0,0,0,0,0,0,0,
0,0,0,0,0,0,0,0,0,0,0,0,0,0,0,0,0,0,0,0,0,0,0,0,0,0,0,0,0,0,0,0,0,0,0,0,0,0,0,0,
0,0,0,0,0,0,0,0,0,0,0,0,0,0,0,0,0,0,0,0,0,0,0,0,0,0,0,0,0,0,0,0,0,0,0,0,0,0,0,0,
0,0,0,0,0,0,0,0,0,0,0,0,0,0,2376,0,0,0,0,0,0,0,0,0,0,0,0,2376,0,2376,0,0,0,0,0,0,0,0,0,0,
0,0,0,0,0,0,0,0,0,0,0,0,0,0,0,2376,0,0,0,0,0,2376,0,0,0,0,0,0,0,0,2376,0,0,0,0,0,0,0,0,0,
0,0,0,0,0,0,0,0,2376,0,0,0,0,0,0,0,0,0,0,0,0,0,0,0,0,0,0,0,0,0,0,0,0,0,0,0,0,0,0,0,
0,0,0,0,0,0,0,0,0,0,2376,0,0,0,0,0,0,0,0,0,0,0,2376,0,0,0,0,0,2376,0,0,0,0,0,0,0,0,0,0,0,
0,0,0,0,0,0,0,0,0,0,0,0,0,0,0,0,0,0,0,0,0,0,0,2376,0,0,0,0,0,0,0,0,0,0,0,0,0,0,0,0,
0,0,0,0,0,0,0,0,0,0,0,0,0,0,0,0,0,0,2376,0,0,0,0,0,0,0,0,0,0,0,0,0,0,0,0,0,0,0,0,0,
0,0,0,0,0,0,0,0,0,0,0,0,0,0,0,0,0,0,0,0,0,0,0,0,0,0,0,0,0,0,0,0,0,0,0,0,0,0,0,0,
0,0,0,0,0,0,0,0,0,0,0,0,0,0,0,0,0,0,0,0,0,0,0,0,0,0,0,0,0,0,0,0,0,0,0,0,0,0,0,0,
0,0,0,0,0,0,0,0,0,0,0,0,0,0,0,0,0,0,0,0,0,0,0,0,0,0,0,0,0,0,0,0,0,0,0,0,0,0,0,0,
0,0,0,0,0,0,0,0,0,0,0,0,0,0,0,0,0,0,0,0,0,0,0,0,0,0,0,0,0,0,0,0,0,0,0,0,0,0,0,0,
0,0,0,0,0,0,0,0,0,0,0,0,0,0,0,0,0,0,0,0,0,0,0,0,0,0,0,0,0,0,0,0,0,0,0,0,0,0,0,0,
0,0,0,0,0,0,0,0,0,0,0,0,0,0,0,0,0,0,0,0,0,0,0,0,0,0,0,0,0,0,0,0,0,0,0,0,0,0,0,0,
0,0,0,0,0,0,0,0,0,0,0,0,0,0,0,0,0,0,0,0,0,0,0,0,0,0,0,0,0,0,0,0,0,0,0,0,0,0,0,0,
0,0,0,0,0,0,0,0,0,0,0,0,0,0,0,0,0,0,0,0,0,0,0,0,0,0,0,0,0,0,0,0,0,0,0,0,0,0,0,0,
0,0,0,0,0,0,0,0,0,0,0,0,0,0,0,0,0,0,0,0,0,0,0,0,0,0,0,0,0,0,0,0,0,0,0,0,0,0,0,0,
0,0,0,0,0,0,0,0,0,0,0,0,0,0,0,0,0,0,0,0,0,0,0,0,0,0,0,0,0,0,0,0,0,0,0,0,0,0,0,0
END LAYER
END MAP
START PROPERTIES
Player,200,370
BackgroundMusic,shadowDungeonTheme,audio/bgm/ShadowDungeon.mp3
Portal,200,400,puzzleScreen,160,20
Portal,210,400,puzzleScreen,170,20
Puzzle,Chest,170,160,10,10,Key
Puzzle,Chest,200,160,10,10,Ammo
Puzzle,Chest,190,160,10,10,Ammo
Puzzle,Chest,180,160,10,10,Ammo
Enemy,SnakeEnemy,160,230
Enemy,SnakeEnemy,210,240
PhantomBoss,200,70,15,25
Sign,235,145,Shoot the phantom in the face with an arrow to deal damge. You cannot save when you enter the room above!,50
END PROPERTIES