SnowVillageCaveTilesheet,img/TileSheets/SnowVillageCaveTilesheet2.png,16
0,0,0,0,0,0,0,0,0,0,0,0,0,0,0,0,0,0,0,0,0,0,0,0,0,0,0,0,0,0,0,0,0,0,0,0,0,0,0,0,0,0,0,0,0,0,0,0,0,0,0,0,0,0,0,0,0,0,0,0,0,0,0,0,0,
0,0,0,0,0,0,0,0,0,0,0,0,0,0,0,0,0,0,0,0,0,0,0,0,0,0,0,0,0,0,0,0,0,0,0,0,0,0,0,0,0,0,0,0,0,0,0,0,0,0,0,0,0,0,0,0,0,0,0,0,0,0,0,0,0,
0,0,0,0,0,0,0,0,0,0,145,146,145,146,145,85,145,146,145,146,145,146,0,0,0,0,0,0,0,0,0,0,0,146,145,146,145,146,145,146,145,146,145,146,145,146,145,146,145,146,145,146,145,146,145,146,145,146,145,146,0,0,0,0,0,
0,0,0,0,0,0,0,0,0,0,161,162,161,162,100,101,102,162,161,162,161,162,0,0,0,0,0,0,0,0,0,0,0,162,161,162,161,162,161,162,161,162,161,162,161,162,161,162,161,129,161,162,161,162,161,162,161,162,161,162,0,0,0,0,0,
0,0,0,0,0,0,0,0,0,0,145,146,145,146,145,146,145,146,145,146,145,146,0,0,0,0,0,0,0,0,0,0,0,146,145,146,130,146,145,146,145,114,145,146,145,146,145,146,145,146,145,146,114,146,145,146,145,146,145,146,0,0,0,0,0,
0,0,0,0,0,0,0,0,0,0,161,162,114,162,161,162,161,162,161,114,161,162,0,0,0,0,0,0,0,0,0,0,0,162,161,162,161,162,161,162,161,162,161,162,161,162,130,162,161,162,161,162,161,162,161,162,161,114,161,162,0,0,0,0,0,
0,0,0,0,0,0,0,0,0,0,145,146,145,146,145,146,129,146,145,146,145,146,145,146,0,0,0,0,0,0,0,0,0,146,145,146,114,146,145,146,145,146,145,146,145,146,145,146,145,146,145,146,145,146,145,146,145,146,145,146,0,0,0,0,0,
0,0,0,0,0,0,0,0,0,0,161,162,113,162,161,162,161,162,161,162,161,162,161,162,0,0,0,0,0,0,0,0,0,162,161,162,161,162,0,0,0,0,0,0,0,0,0,0,0,0,0,0,0,0,0,0,161,162,161,162,0,0,0,0,0,
0,0,0,0,0,0,0,0,0,0,145,146,145,146,145,114,145,146,130,146,145,146,145,146,0,0,0,0,0,0,0,0,0,146,145,117,118,146,305,306,307,308,309,310,305,306,307,308,309,310,305,306,307,308,309,310,145,146,145,146,0,0,0,0,0,
0,0,0,0,0,0,0,162,161,162,161,162,161,162,161,162,161,162,161,162,161,113,161,162,0,0,0,0,0,0,0,0,0,162,161,133,134,162,321,322,323,324,325,326,321,322,323,324,325,326,321,322,323,324,325,326,161,117,118,162,0,0,0,0,0,
0,0,0,0,0,0,0,146,145,146,145,146,145,114,145,146,145,146,145,146,145,146,145,146,0,0,0,0,0,0,0,0,0,146,145,146,145,146,305,306,307,308,309,310,305,306,307,308,309,310,305,306,307,308,309,310,145,133,134,146,0,0,0,0,0,
0,0,0,0,0,0,0,162,161,162,161,162,161,162,161,162,161,162,161,114,161,130,161,162,0,0,0,0,0,0,0,0,0,162,161,162,161,162,321,322,323,324,325,326,321,322,323,324,325,326,321,322,323,324,325,326,161,162,161,162,0,0,0,0,0,
0,0,0,0,0,0,0,146,145,146,145,146,113,146,145,146,129,146,145,146,145,146,145,146,0,0,0,0,0,0,0,0,0,146,145,114,145,146,305,306,307,308,309,310,305,306,307,308,309,310,305,306,307,308,309,310,145,114,145,146,0,0,0,0,0,
0,0,0,0,0,0,0,162,161,113,161,162,161,162,161,162,161,162,161,162,161,162,161,162,0,0,0,0,0,0,0,0,0,162,161,162,161,162,321,322,323,324,325,326,321,322,323,324,325,326,321,322,323,324,325,326,161,162,161,162,0,0,0,0,0,
0,0,0,0,0,0,0,146,145,0,114,146,145,146,114,146,145,146,145,146,145,146,145,146,0,0,0,0,0,0,0,0,0,146,145,146,145,146,305,306,307,308,309,310,305,306,307,308,309,310,305,306,307,308,309,310,145,146,145,146,0,0,0,0,0,
0,0,0,0,0,0,0,162,161,162,161,162,161,162,161,162,113,162,161,0,0,0,0,0,0,0,0,0,0,0,0,0,0,162,161,162,161,162,321,322,323,324,325,326,321,322,323,324,325,326,321,322,323,324,325,326,161,162,161,162,0,0,0,0,0,
0,0,0,0,0,0,0,146,145,146,145,146,145,146,145,146,145,146,145,0,0,0,0,0,0,0,0,0,0,0,0,0,0,146,145,146,113,146,305,306,307,308,309,310,305,306,307,308,309,310,305,306,307,308,309,310,145,146,145,146,0,0,0,0,0,
0,0,0,0,0,0,0,162,161,162,161,162,161,162,161,162,161,162,161,0,0,0,0,0,0,0,0,0,0,0,0,0,0,162,161,162,161,162,321,322,323,324,325,326,321,322,323,324,325,326,321,322,323,324,325,326,161,162,130,162,0,0,0,0,0,
0,0,0,0,0,0,0,146,145,146,145,146,113,146,145,146,145,146,145,0,0,0,0,0,0,0,0,0,0,0,0,0,0,146,145,146,145,146,305,306,307,308,309,310,305,306,307,308,309,310,305,306,307,308,309,310,145,146,145,146,0,0,0,0,0,
0,0,0,0,0,0,0,162,161,162,161,162,161,162,161,162,161,162,161,0,0,0,0,0,0,0,0,0,0,0,0,0,0,162,161,114,161,162,161,162,161,162,161,162,161,162,161,162,129,162,161,162,161,162,161,162,161,162,161,162,0,0,0,0,0,
0,0,0,0,0,0,0,146,145,146,145,146,145,114,145,146,145,146,145,0,0,0,0,0,0,0,0,0,0,0,0,0,0,146,145,117,118,146,145,146,145,146,145,146,145,146,145,146,145,146,145,146,114,146,145,146,145,146,145,146,0,0,0,0,0,
0,0,0,0,0,0,0,162,161,162,161,162,117,118,161,162,161,162,161,0,0,0,0,0,0,0,0,0,0,0,0,0,0,162,161,133,134,162,161,130,161,162,161,162,161,162,161,162,161,162,161,162,161,162,161,162,161,114,161,146,0,0,0,0,0,
0,0,0,0,0,0,0,146,145,146,145,146,133,134,145,146,145,146,145,0,0,0,0,0,0,0,0,0,0,0,0,0,0,146,145,146,145,146,145,146,145,146,145,146,145,114,145,146,145,113,145,146,145,146,145,146,145,146,145,162,0,0,0,0,0,
0,0,0,0,0,0,0,162,161,162,161,162,161,162,161,162,161,162,161,0,0,0,0,0,0,0,0,0,0,0,0,0,0,162,161,162,161,162,161,162,161,162,161,162,161,162,161,162,161,162,161,162,161,162,161,162,161,162,161,162,0,0,0,0,0,
0,0,0,0,0,0,0,146,145,146,145,146,114,146,145,146,145,146,145,0,0,0,0,0,0,0,0,0,0,0,0,0,0,0,0,0,0,0,0,0,0,0,145,146,145,146,145,146,145,146,145,146,145,0,0,0,0,0,0,0,0,0,0,0,0,
0,0,0,0,0,0,0,162,161,162,161,162,161,162,161,162,161,162,161,0,0,0,0,0,0,0,0,0,0,0,0,0,0,0,0,0,0,0,0,0,0,0,161,162,161,130,161,162,161,162,161,162,161,0,0,0,0,0,0,0,0,0,0,0,0,
0,0,0,0,0,0,0,146,145,146,145,146,145,114,145,146,145,146,145,0,0,0,0,0,145,146,145,146,145,146,145,146,145,146,145,146,145,146,145,146,145,146,145,146,145,146,145,146,132,114,145,146,145,0,0,0,0,0,0,0,0,0,0,0,0,
0,0,0,0,0,0,0,162,161,162,161,162,161,162,161,162,161,162,161,0,0,0,0,0,161,162,161,162,161,162,161,162,161,162,161,162,161,162,161,162,161,162,161,162,161,162,161,162,161,162,161,162,161,0,0,0,0,0,0,0,0,0,0,0,0,
0,0,0,0,0,0,0,146,145,146,145,146,145,146,145,146,145,146,145,0,0,0,0,0,145,146,145,146,145,146,145,146,145,146,145,146,145,146,145,146,145,146,145,146,145,146,145,146,145,146,129,146,145,0,0,0,0,0,0,0,0,0,0,0,0,
0,0,0,0,0,0,0,162,161,162,161,162,130,162,161,162,161,130,161,0,0,0,0,0,161,162,130,162,161,162,161,162,161,162,161,162,161,162,161,162,161,162,161,162,161,114,161,162,161,162,161,162,161,0,0,0,0,0,0,0,0,0,0,0,0,
0,0,0,0,0,0,0,146,145,114,145,146,145,146,113,146,145,146,145,0,0,0,0,0,145,146,145,146,145,146,145,146,145,146,145,146,130,146,145,146,145,146,145,146,145,146,145,146,113,146,145,146,145,0,0,0,0,0,0,0,0,0,0,0,0,
0,0,0,0,0,0,0,162,161,162,161,0,161,162,161,162,161,162,161,162,161,162,161,162,161,162,161,162,161,114,161,162,113,162,161,162,161,162,161,162,161,162,161,162,161,162,161,162,161,162,161,162,161,0,0,0,0,0,0,0,0,0,0,0,0,
0,0,0,0,0,0,0,146,145,146,145,146,145,146,145,146,114,146,145,146,145,146,145,146,145,146,145,146,145,146,145,146,145,146,145,146,145,146,145,146,145,146,145,146,145,146,145,146,145,146,145,146,145,0,0,0,0,0,0,0,0,0,0,0,0,
0,0,0,0,0,0,0,0,0,0,0,0,161,162,161,162,161,162,161,162,161,162,161,162,161,162,161,162,161,162,161,162,161,162,161,162,114,162,161,162,161,0,0,0,0,0,0,0,0,0,0,0,0,0,0,0,0,0,0,0,0,0,0,0,0,
0,0,0,0,0,0,0,0,0,0,0,0,145,146,145,146,145,146,145,146,145,146,145,146,145,146,145,130,145,117,118,146,129,146,145,146,145,146,145,146,145,0,0,0,0,0,0,0,0,0,0,0,0,0,0,0,0,0,0,0,0,0,0,0,0,
0,0,0,0,0,0,0,0,0,0,0,0,161,162,130,162,161,162,130,162,161,162,161,114,161,162,161,162,161,133,134,162,161,162,161,132,161,162,0,162,161,0,0,0,0,0,0,0,0,0,0,0,0,0,0,0,0,0,0,0,0,0,0,0,0,
0,0,0,0,0,0,0,0,0,0,0,0,145,146,145,146,145,146,145,146,145,146,145,146,145,146,145,146,145,146,145,146,145,146,145,146,145,146,145,146,145,0,0,0,0,0,0,0,0,0,0,0,0,0,0,0,0,0,0,0,0,0,0,0,0,
0,0,0,0,0,0,0,0,0,0,0,0,161,162,161,162,161,162,161,162,161,162,161,162,161,162,161,162,113,162,114,0,161,162,161,130,161,162,129,162,161,0,0,0,0,0,0,0,0,0,0,0,0,0,0,0,0,0,0,0,0,0,0,0,0,
0,0,0,0,0,0,0,0,0,0,0,0,0,0,0,0,0,0,0,0,0,0,0,0,145,146,145,146,145,146,145,146,145,146,145,146,145,146,145,146,145,0,0,0,0,0,0,0,0,0,0,0,0,0,0,0,0,0,0,0,0,0,0,0,0,
0,0,0,0,0,0,0,0,0,0,0,0,0,0,0,0,0,0,0,0,0,0,0,0,161,162,161,162,161,162,161,162,161,162,161,162,161,162,161,162,161,0,0,0,0,0,0,0,0,0,0,0,0,0,0,0,0,0,0,0,0,0,0,0,0
END LAYER
55,55,55,55,55,55,55,55,55,55,7,14,15,15,52,53,54,14,14,14,15,8,55,55,55,55,55,55,55,55,55,55,55,55,14,14,15,14,15,14,15,14,15,14,15,14,15,14,15,14,15,14,15,14,15,14,15,14,15,15,8,55,55,55,55,
55,55,55,55,55,55,55,55,55,55,23,30,31,31,68,69,70,30,30,30,31,24,55,55,55,55,55,55,55,55,55,55,55,23,30,30,31,30,31,30,31,30,31,30,31,30,31,30,31,30,31,30,31,30,31,30,31,30,31,31,24,55,55,55,55,
55,55,55,55,55,55,55,55,55,55,39,46,47,47,84,0,86,46,46,46,47,40,55,55,55,55,55,55,55,55,55,55,55,39,46,46,47,46,47,46,47,46,47,46,47,46,47,46,47,46,47,46,47,46,47,46,47,46,47,47,40,55,55,55,55,
55,55,55,55,55,55,55,55,55,55,23,0,0,0,0,0,0,0,0,0,0,24,55,55,55,55,55,55,55,55,55,55,55,39,0,0,0,0,0,0,0,0,0,0,0,0,0,0,0,0,0,0,0,0,0,0,0,0,0,0,40,55,55,55,55,
55,55,55,55,55,55,55,55,55,55,23,0,0,0,0,0,0,0,0,0,0,24,55,55,55,55,55,55,55,55,55,55,55,23,0,0,0,0,0,0,0,0,0,0,0,0,0,0,0,0,0,0,0,0,0,0,0,0,0,0,40,55,55,55,55,
55,55,55,55,55,55,55,55,55,55,23,0,0,0,0,0,0,0,0,0,0,40,55,55,55,55,55,55,55,55,55,55,55,39,0,0,0,0,0,0,0,0,0,0,0,0,0,0,0,0,0,0,0,0,0,0,0,0,0,0,40,55,55,55,55,
55,55,55,55,55,55,55,55,55,55,23,0,0,0,0,0,0,0,0,0,0,13,14,8,55,55,55,55,55,55,55,55,55,39,0,0,0,0,0,0,0,0,0,0,0,0,0,0,0,0,0,0,0,0,0,0,0,0,0,0,40,55,55,55,55,
55,55,55,55,55,55,55,55,55,55,23,0,0,0,0,0,0,0,0,0,0,29,30,24,55,55,55,55,55,55,55,55,55,39,0,0,0,0,242,210,210,210,210,210,210,210,210,210,210,210,210,210,210,210,210,241,0,0,0,0,40,55,55,55,55,
55,55,55,55,55,55,55,55,55,55,39,0,0,0,0,0,0,0,0,0,0,0,0,40,55,55,55,55,55,55,55,55,55,39,0,0,0,0,195,0,0,0,0,0,0,0,0,0,0,0,0,0,0,0,0,193,0,0,0,0,40,55,55,55,55,
55,55,55,55,55,55,55,7,14,15,16,0,0,0,0,0,0,0,0,0,0,0,0,24,55,55,55,55,55,55,55,55,55,39,0,0,0,0,195,0,0,0,0,0,0,0,0,0,0,0,0,0,0,0,0,193,0,0,0,0,40,55,55,55,55,
55,55,55,55,55,55,55,23,30,31,32,0,0,0,0,0,0,0,0,0,0,0,0,24,55,55,55,55,55,55,55,55,55,23,0,0,0,0,195,0,0,0,0,0,0,0,0,0,0,0,0,0,0,0,0,193,0,0,0,0,40,55,55,55,55,
55,55,55,55,55,55,55,39,46,47,48,0,0,0,0,0,0,0,0,0,0,0,0,40,55,55,55,55,55,55,55,55,55,39,0,0,0,0,195,0,0,0,0,0,0,0,0,0,0,0,0,0,0,0,0,193,0,0,0,0,40,55,55,55,55,
55,55,55,55,55,55,55,23,0,0,0,0,0,0,0,0,0,0,0,0,0,0,0,24,55,55,55,55,55,55,55,55,55,39,0,0,0,0,195,0,0,0,0,0,0,0,0,0,0,0,0,0,0,0,0,193,0,0,0,0,40,55,55,55,55,
55,55,55,55,55,55,55,23,0,0,0,0,0,0,0,0,0,0,0,0,0,0,0,24,55,55,55,55,55,55,55,55,55,39,0,0,0,0,195,0,0,0,0,0,0,0,0,0,0,0,0,0,0,0,0,193,0,0,0,0,40,55,55,55,55,
55,55,55,55,55,55,55,23,0,115,0,0,0,0,0,0,0,0,61,62,63,62,63,76,55,55,55,55,55,55,55,55,55,39,0,0,0,0,195,0,0,0,0,0,0,0,0,0,0,0,0,0,0,0,0,193,0,0,0,0,40,55,55,55,55,
55,55,55,55,55,55,55,39,0,0,0,0,0,0,0,0,0,0,26,55,55,55,55,55,55,55,55,55,55,55,55,55,55,39,0,0,0,0,195,0,0,0,0,0,0,0,0,0,0,0,0,0,0,0,0,193,0,0,0,0,40,55,55,55,55,
55,55,55,55,55,55,55,23,120,120,120,151,0,0,152,120,120,120,26,55,55,55,55,55,55,55,55,55,55,55,55,55,55,39,0,0,0,0,195,0,0,0,0,0,0,0,0,0,0,0,0,0,0,0,0,193,0,0,0,0,40,55,55,55,55,
55,55,55,55,55,55,55,39,137,137,137,103,0,0,105,137,137,137,42,55,55,55,55,55,55,55,55,55,55,55,55,55,55,23,0,0,0,0,195,0,0,0,0,0,0,0,0,0,0,0,0,0,0,0,0,193,0,0,0,0,40,55,55,55,55,
55,55,55,55,55,55,55,23,137,137,137,103,0,0,105,137,137,137,26,55,55,55,55,55,55,55,55,55,55,55,55,55,55,39,0,0,0,0,226,178,178,178,178,178,178,178,178,178,178,178,178,178,178,178,178,225,0,0,0,0,40,55,55,55,55,
55,55,55,55,55,55,55,23,137,137,137,103,0,0,105,137,137,137,26,55,55,55,55,55,55,55,55,55,55,55,55,55,55,23,0,0,0,0,0,0,0,0,0,0,0,0,0,0,0,0,0,0,0,0,0,0,0,0,0,0,40,55,55,55,55,
55,55,55,55,55,55,55,23,137,137,137,103,0,0,105,137,137,137,26,55,55,55,55,55,55,55,55,55,55,55,55,55,55,39,0,0,0,0,0,0,0,0,0,0,0,0,0,0,0,0,0,0,0,0,0,0,0,0,0,0,40,55,55,55,55,
55,55,55,55,55,55,55,23,137,137,137,103,0,0,105,137,137,137,26,55,55,55,55,55,55,55,55,55,55,55,55,55,55,39,0,0,0,0,0,0,0,0,0,0,0,0,0,0,0,0,0,0,0,0,0,0,0,0,0,0,40,55,55,55,55,
55,55,55,55,55,55,55,23,137,137,137,103,0,0,105,137,137,137,26,55,55,55,55,55,55,55,55,55,55,55,55,55,55,39,0,0,0,0,0,0,0,0,0,0,0,0,0,0,0,0,0,0,0,0,0,0,0,0,0,0,40,55,55,55,55,
55,55,55,55,55,55,55,23,137,137,137,103,0,0,105,137,137,137,26,55,55,55,55,55,55,55,55,55,55,55,55,55,55,60,62,63,63,63,63,63,63,63,64,0,0,0,0,0,0,0,0,0,61,62,62,62,62,62,62,62,76,55,55,55,55,
55,55,55,55,55,55,55,23,137,137,137,103,0,0,105,137,137,137,26,55,55,55,55,55,55,55,55,55,55,55,55,55,55,55,55,55,55,55,55,55,55,55,39,0,0,0,0,0,0,0,0,0,26,55,55,55,55,55,55,55,55,55,55,55,55,
55,55,55,55,55,55,55,23,137,137,137,103,0,0,105,137,137,137,26,55,55,55,55,55,55,55,55,55,55,55,55,55,55,55,55,55,55,55,55,55,55,55,39,311,0,0,0,0,0,0,0,0,26,55,55,55,55,55,55,55,55,55,55,55,55,
55,55,55,55,55,55,55,23,137,137,137,103,0,0,105,137,137,137,26,55,55,55,55,55,7,78,79,78,78,78,79,78,78,78,78,79,78,79,79,79,79,78,80,0,0,0,0,0,0,0,0,0,26,55,55,55,55,55,55,55,55,55,55,55,55,
55,55,55,55,55,55,55,23,88,88,88,135,0,0,136,88,88,88,26,55,55,55,55,55,23,94,95,94,94,94,95,94,94,94,94,95,94,95,95,95,95,94,96,0,0,0,0,0,0,0,0,0,26,55,55,55,55,55,55,55,55,55,55,55,55,
55,55,55,55,55,55,55,23,0,0,0,0,0,0,0,0,0,0,26,55,55,55,55,55,39,110,111,110,110,110,111,110,110,110,110,111,110,111,111,111,111,110,112,0,0,0,0,0,0,0,0,0,26,55,55,55,55,55,55,55,55,55,55,55,55,
55,55,55,55,55,55,55,23,0,0,0,0,0,0,0,0,0,0,26,55,55,55,55,55,39,0,0,0,0,0,0,0,0,0,0,0,0,0,0,0,0,0,0,0,0,0,0,0,0,0,0,0,26,55,55,55,55,55,55,55,55,55,55,55,55,
55,55,55,55,55,55,55,23,0,0,0,0,0,0,0,0,0,0,26,55,55,55,55,55,39,0,0,0,0,0,0,0,0,0,0,0,0,0,0,0,0,0,0,0,0,0,0,0,0,0,0,0,26,55,55,55,55,55,55,55,55,55,55,55,55,
55,55,55,55,55,55,55,23,0,0,0,115,0,0,0,0,0,0,13,14,14,14,14,14,80,0,0,0,0,0,0,0,0,0,0,0,0,0,0,0,0,0,0,0,0,0,0,0,0,0,0,0,26,55,55,55,55,55,55,55,55,55,55,55,55,
55,55,55,55,55,55,55,60,62,62,62,63,64,0,0,0,0,0,29,30,30,30,30,30,96,0,0,0,0,0,0,0,0,0,0,0,0,0,0,0,61,62,62,62,62,62,62,62,62,62,62,63,76,55,55,55,55,55,55,55,55,55,55,55,55,
55,55,55,55,55,55,55,55,55,55,55,55,23,0,0,0,0,0,45,46,46,46,46,46,112,0,0,0,0,0,0,0,0,0,0,0,0,0,0,0,40,55,55,55,55,55,55,55,55,55,55,55,55,55,55,55,55,55,55,55,55,55,55,55,55,
55,55,55,55,55,55,55,55,55,55,55,55,23,0,0,0,0,0,0,0,0,0,0,0,0,0,0,0,0,0,0,0,0,0,0,0,0,0,0,0,40,55,55,55,55,55,55,55,55,55,55,55,55,55,55,55,55,55,55,55,55,55,55,55,55,
55,55,55,55,55,55,55,55,55,55,55,55,23,0,0,0,0,0,0,0,0,0,0,0,0,0,0,0,0,0,0,0,0,0,0,0,0,0,131,0,24,55,55,55,55,55,55,55,55,55,55,55,55,55,55,55,55,55,55,55,55,55,55,55,55,
55,55,55,55,55,55,55,55,55,55,55,55,23,0,0,0,0,0,0,0,0,0,0,0,0,0,0,0,0,0,0,0,0,0,0,0,0,0,0,0,40,55,55,55,55,55,55,55,55,55,55,55,55,55,55,55,55,55,55,55,55,55,55,55,55,
55,55,55,55,55,55,55,55,55,55,55,55,60,62,62,62,62,62,62,62,62,62,62,62,64,0,0,0,0,0,0,131,0,0,0,0,0,0,0,0,24,55,55,55,55,55,55,55,55,55,55,55,55,55,55,55,55,55,55,55,55,55,55,55,55,
55,55,55,55,55,55,55,55,55,55,55,55,55,55,55,55,55,55,55,55,55,55,55,55,90,0,0,0,0,0,0,0,0,0,0,0,0,0,0,0,40,55,55,55,55,55,55,55,55,55,55,55,55,55,55,55,55,55,55,55,55,55,55,55,55,
55,55,55,55,55,55,55,55,55,55,55,55,55,55,55,55,55,55,55,55,55,55,55,55,60,62,62,62,62,62,62,62,62,62,62,62,62,62,62,63,76,55,55,55,55,55,55,55,55,55,55,55,55,55,55,55,55,55,55,55,55,55,55,55,55
END LAYER
0,0,0,0,0,0,0,0,0,0,0,0,0,0,0,0,0,0,0,0,0,0,0,0,0,0,0,0,0,0,0,0,0,0,0,0,0,0,0,0,0,0,0,0,0,0,0,0,0,0,0,0,0,0,0,0,0,0,0,0,0,0,0,0,0,
0,0,0,0,0,0,0,0,0,0,0,0,0,0,0,0,0,0,0,0,0,0,0,0,0,0,0,0,0,0,0,0,0,0,0,0,0,0,0,0,0,0,0,0,0,0,0,0,0,0,0,0,0,0,0,0,0,0,0,0,0,0,0,0,0,
0,0,0,0,0,0,0,0,0,0,0,0,0,0,0,0,0,0,0,0,0,0,0,0,0,0,0,0,0,0,0,0,0,0,0,0,0,0,0,0,0,0,0,0,0,0,0,0,0,0,0,0,0,0,0,0,0,0,0,0,0,0,0,0,0,
0,0,0,0,0,0,0,0,0,0,0,0,0,0,0,0,0,0,0,0,0,0,0,0,0,0,0,0,0,0,0,0,0,0,0,0,0,0,0,0,0,0,0,0,0,0,0,0,0,0,0,0,0,0,0,0,0,0,0,0,0,0,0,0,0,
0,0,0,0,0,0,0,0,0,0,0,0,0,0,0,0,0,0,0,0,0,0,0,0,0,0,0,0,0,0,0,0,0,0,0,0,0,0,0,0,0,0,0,0,0,0,0,0,0,0,0,0,0,0,0,0,0,0,0,0,0,0,0,0,0,
0,0,0,0,0,0,0,0,0,0,0,0,0,0,0,0,0,0,0,0,0,0,0,0,0,0,0,0,0,0,0,0,0,0,0,0,0,0,0,0,0,0,0,0,0,0,0,0,0,0,0,0,0,0,0,0,0,0,0,0,0,0,0,0,0,
0,0,0,0,0,0,0,0,0,0,0,0,0,0,0,0,0,0,0,0,0,0,0,0,0,0,0,0,0,0,0,0,0,0,0,0,0,0,0,0,0,0,0,0,0,0,0,0,0,0,0,0,0,0,0,0,0,0,0,0,0,0,0,0,0,
0,0,0,0,0,0,0,0,0,0,0,0,0,0,0,0,0,0,0,0,0,0,0,0,0,0,0,0,0,0,0,0,0,0,0,0,0,0,0,0,0,0,0,0,0,0,0,0,0,0,0,0,0,0,0,0,0,0,0,0,0,0,0,0,0,
0,0,0,0,0,0,0,0,0,0,0,0,0,0,0,0,0,0,0,0,0,0,0,0,0,0,0,0,0,0,0,0,0,0,0,0,0,0,0,0,0,0,0,0,0,0,0,0,0,0,0,0,0,0,0,0,0,0,0,0,0,0,0,0,0,
0,0,0,0,0,0,0,0,0,0,0,0,0,0,0,0,0,0,0,0,0,0,0,0,0,0,0,0,0,0,0,0,0,0,0,0,0,0,0,0,0,0,0,0,0,0,0,0,0,0,0,0,0,0,0,0,0,0,0,0,0,0,0,0,0,
0,0,0,0,0,0,0,0,0,0,0,0,0,0,0,0,0,0,0,0,0,0,0,0,0,0,0,0,0,0,0,0,0,0,0,0,0,0,0,0,0,0,0,0,0,0,0,0,0,0,0,0,0,0,0,0,0,0,0,0,0,0,0,0,0,
0,0,0,0,0,0,0,0,0,0,0,0,0,0,0,0,0,0,0,0,0,0,0,0,0,0,0,0,0,0,0,0,0,0,0,0,0,0,0,0,0,0,0,0,0,0,0,0,0,0,0,0,0,0,0,0,0,0,0,0,0,0,0,0,0,
0,0,0,0,0,0,0,0,0,0,0,0,0,0,0,0,0,0,0,0,0,0,0,0,0,0,0,0,0,0,0,0,0,0,0,0,0,0,0,0,0,0,0,0,0,0,0,0,0,0,0,0,0,0,0,0,0,0,0,0,0,0,0,0,0,
0,0,0,0,0,0,0,0,0,0,0,0,0,0,0,0,0,0,0,0,0,0,0,0,0,0,0,0,0,0,0,0,0,0,0,0,0,0,0,0,0,0,0,0,0,0,0,0,0,0,0,0,0,0,0,0,0,0,0,0,0,0,0,0,0,
0,0,0,0,0,0,0,0,0,0,0,0,0,0,0,0,0,0,0,0,0,0,0,0,0,0,0,0,0,0,0,0,0,0,0,0,0,0,0,0,0,0,0,0,0,0,0,0,0,0,0,0,0,0,0,0,0,0,0,0,0,0,0,0,0,
0,0,0,0,0,0,0,0,0,0,0,0,0,0,0,0,0,0,0,0,0,0,0,0,0,0,0,0,0,0,0,0,0,0,0,0,0,0,0,0,0,0,0,0,0,0,0,0,0,0,0,0,0,0,0,0,0,0,0,0,0,0,0,0,0,
0,0,0,0,0,0,0,0,0,0,0,0,0,0,0,0,0,0,0,0,0,0,0,0,0,0,0,0,0,0,0,0,0,0,0,0,0,0,0,0,0,0,0,0,0,0,0,0,0,0,0,0,0,0,0,0,0,0,0,0,0,0,0,0,0,
0,0,0,0,0,0,0,0,0,0,0,0,0,0,0,0,0,0,0,0,0,0,0,0,0,0,0,0,0,0,0,0,0,0,0,0,0,0,0,0,0,0,0,0,0,0,0,0,0,0,0,0,0,0,0,0,0,0,0,0,0,0,0,0,0,
0,0,0,0,0,0,0,0,0,0,0,0,0,0,0,0,0,0,0,0,0,0,0,0,0,0,0,0,0,0,0,0,0,0,0,0,0,0,0,0,0,0,0,0,0,0,0,0,0,0,0,0,0,0,0,0,0,0,0,0,0,0,0,0,0,
0,0,0,0,0,0,0,0,0,0,0,0,0,0,0,0,0,0,0,0,0,0,0,0,0,0,0,0,0,0,0,0,0,0,0,0,0,0,0,0,0,0,0,0,0,0,0,0,0,0,0,0,0,0,0,0,0,0,0,0,0,0,0,0,0,
0,0,0,0,0,0,0,0,0,0,0,0,0,0,0,0,0,0,0,0,0,0,0,0,0,0,0,0,0,0,0,0,0,0,0,0,0,0,0,0,0,0,0,0,0,0,0,0,0,0,0,0,0,0,0,0,0,0,0,0,0,0,0,0,0,
0,0,0,0,0,0,0,0,0,0,0,0,0,0,0,0,0,0,0,0,0,0,0,0,0,0,0,0,0,0,0,0,0,0,0,0,0,0,0,0,0,0,0,0,0,0,0,0,0,0,0,0,0,0,0,0,0,0,0,0,0,0,0,0,0,
0,0,0,0,0,0,0,0,0,0,0,0,0,0,0,0,0,0,0,0,0,0,0,0,0,0,0,0,0,0,0,0,0,0,0,0,0,0,0,0,0,0,0,0,0,0,0,0,0,0,0,0,0,0,0,0,0,0,0,0,0,0,0,0,0,
0,0,0,0,0,0,0,0,0,0,0,0,0,0,0,0,0,0,0,0,0,0,0,0,0,0,0,0,0,0,0,0,0,0,0,0,0,0,0,0,0,0,0,0,0,0,0,0,0,0,0,0,0,0,0,0,0,0,0,0,0,0,0,0,0,
0,0,0,0,0,0,0,0,0,0,0,0,0,0,0,0,0,0,0,0,0,0,0,0,0,0,0,0,0,0,0,0,0,0,0,0,0,0,0,0,0,0,0,0,0,0,0,0,0,0,0,0,0,0,0,0,0,0,0,0,0,0,0,0,0,
0,0,0,0,0,0,0,0,0,0,0,0,0,0,0,0,0,0,0,0,0,0,0,0,0,0,0,0,0,0,0,0,0,0,0,0,0,0,0,0,0,0,0,0,0,0,0,0,0,0,0,0,0,0,0,0,0,0,0,0,0,0,0,0,0,
0,0,0,0,0,0,0,0,0,0,0,0,0,0,0,0,0,0,0,0,0,0,0,0,0,0,0,0,0,0,0,0,0,0,0,0,0,0,0,0,0,0,0,0,0,0,0,0,0,0,0,0,0,0,0,0,0,0,0,0,0,0,0,0,0,
0,0,0,0,0,0,0,0,0,0,0,0,0,0,0,0,0,0,0,0,0,0,0,0,0,0,0,0,0,0,0,0,0,0,0,0,0,0,0,0,0,0,0,0,0,0,0,0,0,0,0,0,0,0,0,0,0,0,0,0,0,0,0,0,0,
0,0,0,0,0,0,0,0,0,0,0,0,0,0,0,0,0,0,0,0,0,0,0,0,0,0,0,0,0,0,0,0,0,0,0,0,0,0,0,0,0,0,0,0,0,0,0,0,0,0,0,0,0,0,0,0,0,0,0,0,0,0,0,0,0,
0,0,0,0,0,0,0,0,0,0,0,0,0,0,0,0,0,0,0,0,0,0,0,0,0,0,0,0,0,0,0,0,0,0,0,0,0,0,0,0,0,0,0,0,0,0,0,0,0,0,0,0,0,0,0,0,0,0,0,0,0,0,0,0,0,
0,0,0,0,0,0,0,0,0,0,0,0,0,0,0,0,0,0,0,0,0,0,0,0,0,0,0,0,0,0,0,0,0,0,0,0,0,0,0,0,0,0,0,0,0,0,0,0,0,0,0,0,0,0,0,0,0,0,0,0,0,0,0,0,0,
0,0,0,0,0,0,0,0,0,0,0,0,0,0,0,0,0,0,0,0,0,0,0,0,0,0,0,0,0,0,0,0,0,0,0,0,0,0,0,0,0,0,0,0,0,0,0,0,0,0,0,0,0,0,0,0,0,0,0,0,0,0,0,0,0,
0,0,0,0,0,0,0,0,0,0,0,0,0,0,0,0,0,0,0,0,0,0,0,0,0,0,0,0,0,0,0,0,0,0,0,0,0,0,0,0,0,0,0,0,0,0,0,0,0,0,0,0,0,0,0,0,0,0,0,0,0,0,0,0,0,
0,0,0,0,0,0,0,0,0,0,0,0,0,0,0,0,0,0,0,0,0,0,0,0,0,0,0,0,0,0,0,0,0,0,0,0,0,0,0,0,0,0,0,0,0,0,0,0,0,0,0,0,0,0,0,0,0,0,0,0,0,0,0,0,0,
0,0,0,0,0,0,0,0,0,0,0,0,0,0,0,0,0,0,0,0,0,0,0,0,0,0,0,0,0,0,0,0,0,0,0,0,0,0,0,0,0,0,0,0,0,0,0,0,0,0,0,0,0,0,0,0,0,0,0,0,0,0,0,0,0,
0,0,0,0,0,0,0,0,0,0,0,0,0,0,0,0,0,0,0,0,0,0,0,0,0,0,0,0,0,0,0,0,0,0,0,0,0,0,0,0,0,0,0,0,0,0,0,0,0,0,0,0,0,0,0,0,0,0,0,0,0,0,0,0,0,
0,0,0,0,0,0,0,0,0,0,0,0,0,0,0,0,0,0,0,0,0,0,0,0,0,0,0,0,0,0,0,0,0,0,0,0,0,0,0,0,0,0,0,0,0,0,0,0,0,0,0,0,0,0,0,0,0,0,0,0,0,0,0,0,0,
0,0,0,0,0,0,0,0,0,0,0,0,0,0,0,0,0,0,0,0,0,0,0,0,0,0,0,0,0,0,0,0,0,0,0,0,0,0,0,0,0,0,0,0,0,0,0,0,0,0,0,0,0,0,0,0,0,0,0,0,0,0,0,0,0,
0,0,0,0,0,0,0,0,0,0,0,0,0,0,0,0,0,0,0,0,0,0,0,0,0,0,0,0,0,0,0,0,0,0,0,0,0,0,0,0,0,0,0,0,0,0,0,0,0,0,0,0,0,0,0,0,0,0,0,0,0,0,0,0,0,
0,0,0,0,0,0,0,0,0,0,0,0,0,0,0,0,0,0,0,0,0,0,0,0,0,0,0,0,0,0,0,0,0,0,0,0,0,0,0,0,0,0,0,0,0,0,0,0,0,0,0,0,0,0,0,0,0,0,0,0,0,0,0,0,0
END LAYER
END MAP
START PROPERTIES
Player,155,45
BackgroundMusic,SnowVillageCaveBgm,audio/bgm/SnowVillageCaveBgm.mp3
Portal,155,25,snowVillage,185,375
Sign,435,255,To fight Dodongo: when he inhales feed him something explosive!,50
Dodongo,360,130
Enemy,ArcherEnemy,335,375
Enemy,ArcherEnemy,345,315
Enemy,SnakeEnemy,135,125
Enemy,SnakeEnemy,205,105
END PROPERTIES