SnowVillageTileSheet,img/TileSheets/snowVillageTileSheet.png,16
11,11,11,11,11,11,11,11,11,11,11,11,11,11,10,11,11,11,11,11,11,11,11,11,11,11,11,11,11,11,11,11,11,11,11,11,11,11,11,11,11,11,11,11,11,11,11,11,11,11,
11,11,11,11,11,11,11,11,11,11,11,11,11,11,10,11,11,11,11,11,11,11,11,11,11,11,11,11,11,11,11,11,11,11,11,11,11,11,11,11,11,11,11,11,11,11,11,11,11,11,
11,11,11,11,11,11,11,11,11,11,11,11,11,11,10,11,11,11,12,12,11,11,11,11,11,11,11,11,11,11,11,11,11,11,11,11,11,11,11,11,11,11,11,11,11,11,11,11,11,11,
11,12,12,11,11,11,12,11,11,11,11,11,11,11,10,11,11,11,12,11,11,11,11,11,11,11,11,11,11,11,12,11,11,11,11,11,11,11,11,11,12,11,11,12,11,11,12,11,11,11,
11,11,11,11,11,12,11,11,11,11,11,11,11,11,10,11,12,11,11,11,11,11,11,11,11,11,11,11,11,11,11,11,11,11,11,11,11,11,11,11,11,11,11,11,11,11,12,11,11,11,
11,11,11,11,11,12,11,12,11,11,11,11,11,11,10,11,11,11,11,11,11,11,11,12,11,11,11,11,11,11,11,11,11,11,11,11,11,11,11,11,11,11,11,11,12,11,11,11,11,11,
11,11,11,11,11,11,11,11,11,11,11,11,12,11,10,11,11,11,11,11,11,11,11,11,11,11,11,11,11,11,11,11,11,11,11,11,11,11,11,11,11,12,11,11,11,11,11,11,11,11,
11,11,11,12,11,11,11,11,11,11,12,11,11,11,10,11,11,11,11,11,11,12,11,11,11,11,11,11,11,11,11,11,12,12,12,12,11,11,11,11,11,11,11,11,11,11,11,11,11,11,
11,11,12,12,11,11,11,11,11,11,11,11,11,11,10,11,11,11,11,11,11,11,11,11,11,11,11,11,11,11,11,12,11,11,11,12,11,11,11,11,11,11,11,11,12,11,12,11,11,11,
11,11,11,11,11,11,11,11,11,11,8,9,9,9,8,11,11,11,11,11,11,11,11,11,11,11,11,11,11,11,12,12,11,11,11,12,11,11,11,11,11,11,11,11,11,11,12,11,11,11,
11,11,11,11,11,11,11,11,11,11,10,11,11,11,11,11,11,11,11,11,11,11,11,11,11,11,11,11,11,11,12,11,11,11,11,11,11,11,11,11,11,11,11,11,11,11,11,11,11,11,
11,11,11,11,11,11,11,11,11,11,10,11,11,11,11,11,11,11,11,11,11,11,11,11,11,11,11,11,11,11,11,11,11,11,11,11,11,11,11,11,11,11,11,11,11,11,11,12,11,11,
11,11,12,11,11,11,11,11,11,11,10,11,11,11,11,11,11,11,12,11,11,11,11,11,11,11,11,11,11,11,11,11,11,11,11,12,11,11,11,11,11,11,11,11,11,11,11,12,11,11,
11,11,12,11,12,12,11,11,11,11,10,11,11,11,11,12,12,11,12,11,11,11,11,11,11,11,11,11,11,11,11,11,11,11,11,12,11,11,11,11,11,11,11,11,11,11,11,11,11,11,
11,12,12,11,12,11,11,11,11,11,10,11,11,11,11,11,11,11,11,11,11,11,11,11,11,11,11,11,11,11,11,11,11,11,11,12,11,11,11,11,11,12,11,11,11,12,11,11,11,11,
11,11,11,11,12,11,11,11,11,11,10,11,11,11,11,11,11,11,12,11,0,0,0,0,0,0,0,0,11,11,11,11,11,11,12,12,11,11,11,11,11,12,12,11,11,12,11,11,11,11,
11,11,11,11,11,11,12,11,11,11,10,11,11,12,11,11,11,11,12,11,0,0,0,0,0,0,0,0,11,11,12,11,11,11,11,11,12,12,12,11,11,11,12,12,11,12,11,11,11,11,
11,11,11,11,11,11,11,11,11,11,10,11,12,12,11,11,11,12,12,11,0,0,0,0,0,0,0,0,11,11,11,11,11,11,11,11,12,11,12,12,11,11,11,12,11,12,11,11,11,11,
11,11,11,11,11,11,11,11,11,11,10,11,11,11,11,11,11,11,11,11,11,11,11,11,11,11,11,11,11,11,11,11,11,11,11,11,11,11,11,11,11,11,11,12,12,12,11,11,11,11,
11,11,12,12,12,11,11,11,11,11,8,9,9,9,9,9,9,9,8,9,9,9,9,9,9,9,9,9,9,9,9,9,9,9,9,8,11,11,11,11,11,11,11,11,11,12,11,11,11,11,
11,11,11,11,11,11,11,11,11,11,11,11,11,11,11,11,11,11,10,11,11,11,11,11,11,11,11,11,11,11,11,11,11,11,11,10,11,11,11,11,11,11,11,11,11,11,11,11,11,11,
11,11,11,12,11,12,11,11,12,11,11,11,11,11,11,11,11,11,10,11,11,11,11,11,11,11,11,11,11,11,11,11,11,11,11,10,12,11,11,11,12,11,11,11,11,12,11,11,11,11,
11,11,11,11,11,11,11,11,12,12,11,11,11,11,11,11,11,11,10,11,11,11,12,11,11,12,12,12,12,11,11,11,11,11,11,10,12,11,11,11,11,11,11,11,11,12,12,11,11,11,
11,11,11,11,11,11,11,11,12,12,11,11,0,0,0,0,11,11,10,11,11,12,12,11,11,12,11,11,11,11,11,11,12,12,11,10,12,12,11,11,11,11,11,11,11,11,12,12,11,11,
11,11,11,11,12,11,11,11,11,11,11,11,0,0,0,0,11,11,10,11,11,11,0,0,0,0,0,0,0,0,0,0,12,11,11,10,11,11,11,11,11,11,11,11,11,11,11,11,11,11,
11,11,11,12,12,11,11,11,11,11,11,11,11,11,11,11,11,11,10,11,11,11,0,0,0,0,0,0,0,0,0,0,11,11,12,10,11,11,11,11,11,11,11,11,11,11,11,11,11,11,
11,11,11,12,11,11,11,11,11,11,11,11,11,11,11,11,11,11,10,11,11,11,0,0,0,0,0,0,0,0,0,0,11,12,12,10,11,11,11,11,11,11,11,11,11,11,12,11,11,11,
11,11,12,12,11,11,11,11,11,11,11,12,11,11,11,11,11,11,10,11,11,11,11,11,11,11,12,12,11,11,11,11,12,12,11,10,11,12,12,12,12,12,11,11,11,11,12,11,11,11,
11,11,11,12,11,11,11,11,11,11,12,12,11,12,12,11,11,11,10,12,12,12,12,11,11,11,11,11,11,11,11,11,11,11,12,10,12,11,11,11,11,11,11,11,11,11,11,11,11,11,
11,11,11,12,11,11,12,12,12,11,12,11,11,11,11,11,11,11,8,9,9,9,9,9,9,9,9,9,9,9,12,11,11,11,11,8,9,9,8,11,11,11,0,0,0,0,11,11,11,11,
11,11,11,11,11,11,11,11,11,11,11,11,11,11,12,11,11,11,10,11,11,11,11,11,11,11,11,11,11,11,11,11,11,11,11,11,12,11,10,11,11,11,0,0,0,0,11,11,11,11,
11,11,12,11,11,12,11,11,11,11,11,11,11,11,11,11,11,11,10,11,11,11,11,11,11,11,12,11,12,11,11,11,11,11,12,11,12,11,10,11,12,11,0,0,0,0,11,11,11,11,
11,11,12,11,11,11,11,11,11,12,12,12,12,11,11,11,11,11,10,11,11,11,11,11,11,11,11,11,11,11,11,11,11,11,11,11,11,11,10,11,11,12,0,0,0,0,11,11,11,11,
11,11,11,11,11,11,11,11,11,11,11,11,11,12,12,11,11,11,10,11,11,11,11,11,11,11,11,11,11,11,11,11,11,11,11,11,11,11,10,11,11,11,11,11,11,11,11,11,11,11,
11,11,11,11,11,12,11,11,11,12,11,11,11,11,11,11,11,11,10,11,11,12,11,11,11,11,11,11,11,11,11,11,11,11,11,11,11,11,8,9,9,12,12,11,11,12,12,11,11,11,
11,11,11,11,11,11,11,11,11,11,12,12,11,11,11,11,11,11,10,11,12,12,11,11,12,12,11,11,11,11,11,12,11,11,12,12,11,11,11,11,12,12,12,12,11,11,12,11,11,11,
11,11,12,11,12,11,11,11,11,11,11,12,12,11,11,12,11,11,10,12,12,11,11,12,12,11,11,11,11,11,11,11,11,11,11,12,12,12,11,11,11,11,11,11,11,11,11,11,11,11,
11,11,12,11,11,11,11,11,11,11,11,11,11,11,11,12,11,11,10,12,11,11,11,11,11,11,11,12,11,11,11,11,12,11,11,11,11,11,11,11,11,11,11,12,12,11,11,11,11,11,
11,11,11,11,11,11,11,12,11,11,11,11,11,11,11,11,11,11,10,11,11,12,12,11,11,11,11,11,11,12,11,11,11,11,11,11,11,11,11,12,11,11,11,11,11,11,11,12,11,11,
11,11,11,11,11,11,11,11,11,11,11,11,11,11,11,11,11,11,10,11,11,11,11,11,11,11,11,11,11,11,11,11,11,11,11,11,11,11,11,11,11,11,11,11,11,11,11,11,11,11
END LAYER
17,17,17,17,17,17,17,17,17,17,17,17,17,0,0,0,17,17,17,17,17,17,17,17,17,17,17,17,17,17,17,17,17,17,17,17,17,17,17,17,17,17,17,17,17,17,17,17,17,17,
18,18,18,18,18,18,18,18,18,18,18,18,18,0,0,0,18,18,18,18,18,18,18,18,18,18,18,18,18,18,18,18,18,18,18,18,18,18,18,18,18,18,18,18,18,18,18,18,18,18,
17,0,0,0,0,0,0,0,0,0,0,0,31,0,0,0,0,0,0,0,0,0,0,0,0,0,0,0,0,0,0,0,0,0,0,0,0,0,0,0,0,0,0,0,0,0,0,0,0,17,
18,0,0,0,0,0,0,0,0,0,0,0,0,0,0,0,0,0,0,0,0,0,0,18,0,0,0,0,0,0,0,0,0,0,18,0,0,0,20,0,18,0,0,0,0,0,0,0,0,18,
17,0,0,0,0,0,0,0,0,0,0,18,0,0,0,0,0,0,0,0,0,0,0,0,0,0,20,0,0,0,0,0,0,0,0,0,0,0,0,0,0,0,0,0,0,18,0,0,0,17,
18,0,0,18,0,0,0,0,0,0,0,0,0,0,0,0,0,0,0,0,18,0,0,0,0,0,0,0,18,0,0,0,0,18,0,0,0,18,0,0,0,0,0,0,0,0,0,0,0,18,
17,0,0,0,0,0,0,0,0,0,0,0,0,0,0,0,0,0,0,0,0,0,0,0,0,0,18,0,0,0,0,0,0,0,0,0,0,0,0,0,0,18,0,0,0,0,0,0,0,17,
18,0,0,0,0,0,0,0,0,0,0,0,0,0,0,0,0,18,0,0,0,0,0,0,0,0,0,0,0,0,18,0,0,0,0,0,0,0,0,0,0,0,0,0,0,0,18,0,0,18,
17,0,0,0,0,0,0,18,0,0,0,0,0,0,0,0,0,0,0,0,0,0,0,0,0,0,0,0,0,0,0,0,0,18,0,0,0,18,0,0,0,0,0,0,0,0,0,0,0,17,
18,0,0,0,0,0,0,0,0,0,0,0,0,0,0,0,0,0,0,0,0,0,0,0,0,0,0,0,0,0,0,0,0,0,0,0,0,0,0,0,20,0,0,0,0,0,0,0,0,18,
17,0,0,0,0,0,0,0,0,0,0,0,0,0,0,0,0,0,0,0,0,0,0,0,0,0,0,0,0,0,0,0,0,0,0,0,0,0,0,0,0,0,0,0,0,0,0,0,0,17,
18,0,0,0,18,0,0,0,0,0,0,0,0,0,0,0,18,0,0,0,0,0,0,0,0,0,0,0,0,0,18,0,0,0,0,0,0,0,0,0,0,0,18,0,0,0,0,0,0,18,
17,0,0,0,0,0,0,0,0,0,0,0,0,0,0,0,0,0,0,0,0,0,0,0,0,0,0,0,0,0,0,0,0,18,0,0,0,0,18,0,0,0,0,0,0,0,18,0,0,17,
18,0,0,0,0,0,0,0,0,0,0,0,0,18,0,0,0,0,0,0,0,0,0,0,0,0,0,0,0,0,0,0,0,0,0,0,0,0,0,0,0,0,0,0,0,0,0,0,0,18,
17,0,0,0,0,20,0,0,18,0,0,0,0,0,0,0,0,0,0,0,0,0,0,0,0,0,0,0,0,0,0,0,0,0,0,0,0,0,0,0,0,0,0,0,0,0,0,0,0,17,
18,0,0,0,0,0,0,0,0,0,0,19,0,0,0,0,18,0,0,0,6,4,1,5,5,1,5,7,0,0,0,18,0,0,0,0,0,0,0,18,0,0,0,18,0,0,0,0,0,18,
17,0,0,0,0,0,0,0,0,0,0,0,0,0,20,0,0,0,0,0,6,1,1,1,1,1,1,7,0,0,0,0,0,0,0,18,0,0,0,0,0,0,0,0,0,0,0,0,0,17,
18,0,18,0,0,0,0,0,0,0,0,0,0,0,0,0,0,0,0,0,6,5,1,2,3,1,5,7,0,20,0,0,0,0,0,0,0,0,0,0,0,0,0,0,0,0,0,0,0,18,
17,0,0,0,0,0,0,0,0,0,0,0,0,0,0,19,0,0,0,0,0,13,0,0,0,0,0,18,0,0,0,19,0,0,0,0,0,0,0,0,0,0,0,0,0,0,18,0,0,17,
18,0,0,0,0,0,18,0,0,0,0,0,0,0,0,0,0,0,0,0,0,0,0,0,0,0,0,0,0,0,0,0,0,0,0,0,0,0,0,18,0,0,0,0,0,0,0,0,0,18,
17,0,0,0,0,0,0,0,0,0,0,0,0,0,0,0,0,0,0,0,0,0,0,0,0,0,0,0,0,0,0,0,0,0,0,0,0,0,0,0,0,0,18,0,0,0,0,0,0,17,
18,0,0,0,0,0,0,0,0,0,0,0,0,0,0,0,0,0,0,0,20,0,0,0,0,0,0,0,0,0,0,0,0,0,0,0,0,0,0,0,0,0,0,0,0,0,0,0,18,18,
17,0,0,0,0,0,0,0,18,0,0,0,0,0,0,0,0,19,0,0,0,0,0,0,0,0,0,0,0,0,0,0,0,0,0,0,0,0,0,0,0,0,0,0,0,0,0,0,0,17,
18,0,18,0,0,0,0,0,0,0,0,0,6,1,1,7,0,0,0,0,0,0,0,0,0,0,0,0,0,0,0,0,0,0,19,0,0,0,18,0,0,0,0,0,0,0,0,0,0,18,
17,0,0,0,0,0,0,0,0,0,0,0,6,3,1,7,0,0,0,19,0,0,6,5,1,5,1,1,4,1,5,7,0,0,0,0,0,0,0,0,0,0,0,0,0,0,0,0,0,17,
18,0,0,0,0,0,18,0,0,0,0,0,13,0,0,16,0,0,0,0,0,0,6,1,1,1,1,1,1,1,1,7,0,0,0,0,0,0,0,0,0,0,0,0,0,0,0,0,0,18,
17,0,0,0,20,0,0,0,0,18,0,0,0,0,0,0,0,0,0,0,0,0,6,4,3,1,1,1,1,3,4,7,0,18,0,0,0,0,0,0,18,0,0,0,0,0,0,0,0,17,
18,0,0,0,0,18,0,0,0,0,0,0,0,0,0,0,0,0,0,0,0,0,13,0,0,0,16,0,13,0,0,0,0,0,0,0,19,0,0,0,0,0,0,0,0,0,0,0,0,18,
17,0,18,0,0,0,0,0,0,0,0,18,0,0,0,0,0,0,0,0,0,0,0,0,0,0,0,0,0,0,0,18,0,0,0,0,0,31,0,0,0,0,0,0,0,0,0,0,0,17,
18,0,0,0,0,0,0,0,0,0,0,0,0,0,0,0,18,0,0,0,0,0,0,0,0,0,0,0,0,0,0,0,0,18,0,0,0,0,0,0,0,0,6,1,1,7,0,0,0,18,
17,0,0,0,0,0,0,0,0,0,0,0,0,0,0,0,0,0,0,0,0,0,0,0,0,0,0,0,0,0,0,0,0,0,0,0,0,0,0,0,0,0,6,5,5,7,0,0,18,17,
18,0,0,0,0,0,0,0,18,0,0,0,0,18,0,0,20,0,0,0,0,0,18,0,0,0,0,0,0,18,0,0,18,0,0,0,0,0,0,19,0,0,6,1,1,7,0,0,0,18,
17,0,0,0,0,18,0,0,0,0,0,0,0,0,0,0,0,0,0,0,0,0,0,0,0,0,18,0,0,0,0,0,0,0,0,0,18,0,0,0,0,0,6,3,3,7,0,0,0,17,
18,0,18,0,0,0,0,0,0,0,0,0,0,0,0,0,0,0,0,0,0,18,0,18,0,0,0,0,0,18,0,18,0,0,0,0,0,0,0,0,0,0,0,0,0,16,0,0,0,18,
17,0,0,0,0,0,0,0,0,0,0,0,0,0,0,18,0,0,0,0,0,0,0,0,0,0,0,0,0,0,0,0,0,18,0,0,0,0,0,0,0,0,0,0,0,0,0,0,0,17,
18,0,0,0,18,0,20,0,0,0,18,0,0,0,0,0,0,0,0,0,0,0,0,0,0,18,0,0,20,0,0,0,0,0,0,18,0,0,0,0,0,0,0,0,0,0,0,14,0,18,
17,0,0,0,0,0,0,0,0,0,0,0,0,18,0,0,31,0,0,0,0,18,0,0,0,0,0,0,0,0,18,0,18,0,0,0,0,0,0,18,0,0,0,0,0,0,0,0,0,17,
18,0,0,0,0,0,0,0,18,0,0,0,0,0,0,0,0,0,0,0,0,0,18,0,0,0,0,18,0,0,0,0,0,18,0,0,18,0,0,0,0,0,20,0,0,0,0,0,0,18,
17,17,17,17,17,17,17,17,17,17,17,17,17,17,17,17,17,0,0,0,17,17,17,17,17,17,17,17,17,17,17,17,17,17,17,17,17,17,17,17,17,17,17,17,17,17,17,17,17,17,
18,18,18,18,18,18,18,18,18,18,18,18,18,18,18,18,18,0,0,0,18,18,18,18,18,18,18,18,18,18,18,18,18,18,18,18,18,18,18,18,18,18,18,18,18,18,18,18,18,18
END LAYER
0,0,0,0,0,0,0,0,0,0,0,0,0,0,0,0,0,0,0,0,0,0,0,0,0,0,0,0,0,0,0,0,0,0,0,0,0,0,0,0,0,0,0,0,0,0,0,0,0,0,
0,0,0,0,0,0,0,0,0,0,0,0,0,0,0,0,0,0,0,0,0,0,0,0,0,0,0,0,0,0,0,0,0,0,0,0,0,0,0,0,0,0,0,0,0,0,0,0,0,0,
0,0,0,0,0,0,0,0,0,0,0,0,0,0,0,0,0,0,0,0,0,0,0,17,0,0,0,0,0,0,0,0,0,0,17,0,0,0,0,0,17,0,0,0,0,0,0,0,0,0,
0,0,0,0,0,0,0,0,0,0,0,17,0,0,0,0,0,0,0,0,0,0,0,0,0,0,0,0,0,0,0,0,0,0,0,0,0,0,0,0,0,0,0,0,0,17,0,0,0,0,
0,0,0,17,0,0,0,0,0,0,0,0,0,0,0,0,0,0,0,0,17,0,0,0,0,0,0,0,17,0,0,0,0,17,0,0,0,17,0,0,0,0,0,0,0,0,0,0,0,0,
0,0,0,0,0,0,0,0,0,0,0,0,0,0,0,0,0,0,0,0,0,0,0,0,0,0,17,0,0,0,0,0,0,0,0,0,0,0,0,0,0,17,0,0,0,0,0,0,0,0,
0,0,0,0,0,0,0,0,0,0,0,0,0,0,0,0,0,17,0,0,0,0,0,0,0,0,0,0,0,0,17,0,0,0,0,0,0,0,0,0,0,0,0,0,0,0,17,0,0,0,
0,0,0,0,0,0,0,17,0,0,0,0,0,0,0,0,0,0,0,0,0,0,0,0,0,0,0,0,0,0,0,0,0,17,0,0,0,17,0,0,0,0,0,0,0,0,0,0,0,0,
0,0,0,0,0,0,0,0,0,0,0,0,0,0,0,0,0,0,0,0,0,0,21,22,29,30,0,0,0,0,0,0,0,0,0,0,0,0,0,0,0,0,0,0,0,0,0,0,0,0,
0,0,0,0,0,0,0,0,0,0,0,0,0,0,0,0,0,0,0,0,21,22,23,23,23,23,29,30,0,0,0,0,0,0,0,0,0,0,0,0,0,0,0,0,0,0,0,0,0,0,
0,0,0,0,17,0,0,0,0,0,0,0,0,0,0,0,17,0,0,0,23,23,24,25,26,27,28,23,0,0,17,0,0,0,0,0,0,0,0,0,0,0,17,0,0,0,0,0,0,0,
0,0,0,0,0,0,0,0,0,0,0,0,0,0,0,0,0,0,0,0,24,25,1,5,5,1,26,27,0,0,0,0,0,17,0,0,0,0,17,0,0,0,0,0,0,0,17,0,0,0,
0,0,0,0,0,0,0,0,0,0,0,0,0,17,0,0,0,0,0,0,6,1,1,1,1,1,1,7,0,0,0,0,0,0,0,0,0,0,0,0,0,0,0,0,0,0,0,0,0,0,
0,0,0,0,0,0,0,0,17,0,0,0,0,0,0,0,0,0,0,0,6,4,1,4,4,1,4,7,0,0,0,0,0,0,0,0,0,0,0,0,0,0,0,0,0,0,0,0,0,0,
0,0,0,0,0,0,0,0,0,0,0,0,0,0,0,0,17,0,0,0,6,1,1,1,1,1,1,7,0,0,0,17,0,0,0,0,0,0,0,17,0,0,0,17,0,0,0,0,0,0,
0,0,0,0,0,0,0,0,0,0,0,0,0,0,0,0,0,0,0,0,0,0,0,0,0,0,0,0,0,0,0,0,0,0,0,17,0,0,0,0,0,0,0,0,0,0,0,0,0,0,
0,0,17,0,0,0,0,0,0,0,0,0,0,0,0,0,0,0,0,0,0,0,0,0,0,0,0,0,0,0,0,0,0,0,0,0,0,0,0,0,0,0,0,0,0,0,0,0,0,0,
0,0,0,0,0,0,0,0,0,0,0,0,0,0,0,0,0,0,0,0,0,0,0,0,0,0,0,17,0,0,0,0,0,0,0,0,0,0,0,0,0,0,0,0,0,0,17,0,0,0,
0,0,0,0,0,0,17,0,0,0,0,0,0,0,0,0,0,0,0,0,0,0,0,0,0,0,0,0,0,0,0,0,0,0,0,0,0,0,0,17,0,0,0,0,0,0,0,0,0,0,
0,0,0,0,0,0,0,0,0,0,0,0,0,21,30,0,0,0,0,0,0,0,0,0,0,0,21,30,0,0,0,0,0,0,0,0,0,0,0,0,0,0,17,0,0,0,0,0,0,0,
0,0,0,0,0,0,0,0,0,0,0,0,22,23,28,29,0,0,0,0,0,0,0,0,21,22,23,28,29,30,0,0,0,0,0,0,0,0,0,0,0,0,0,0,0,0,0,0,17,0,
0,0,0,0,0,0,0,0,17,0,0,0,24,25,26,27,0,0,0,0,0,0,21,22,23,23,24,27,28,28,29,30,0,0,0,0,0,0,0,0,0,0,0,0,0,0,0,0,0,0,
0,0,17,0,0,0,0,0,0,0,0,0,6,5,4,7,0,0,0,0,0,0,23,23,24,25,5,4,26,27,28,28,0,0,0,0,0,0,17,0,0,0,21,22,29,30,0,0,0,0,
0,0,0,0,0,0,0,0,0,0,0,0,0,0,0,0,0,0,0,0,0,0,24,25,1,1,1,1,1,1,26,27,0,0,0,0,0,0,0,0,0,0,23,23,28,28,0,0,0,0,
0,0,0,0,0,0,17,0,0,0,0,0,0,0,0,15,0,0,0,0,0,0,0,0,0,0,0,0,0,0,0,0,0,0,0,0,0,0,0,0,0,0,23,24,27,28,0,0,0,0,
0,0,0,0,0,0,0,0,0,17,0,0,0,0,0,0,0,0,0,0,0,0,0,0,0,0,0,0,0,0,0,0,0,17,0,0,0,0,0,0,17,0,25,1,1,26,0,0,0,0,
0,0,0,0,0,17,0,0,0,0,0,0,0,0,0,0,0,0,0,0,0,0,0,0,0,0,15,0,0,0,0,0,0,0,0,0,0,0,0,0,0,0,6,5,5,7,0,0,0,0,
0,0,17,0,0,0,0,0,0,0,0,17,0,0,0,0,0,0,0,0,0,0,0,0,0,0,0,0,0,0,0,17,0,0,0,0,0,0,0,0,0,0,6,1,1,7,0,0,0,0,
0,0,0,0,0,0,0,0,0,0,0,0,0,0,0,0,17,0,0,0,0,0,0,0,0,0,0,0,0,0,0,0,0,17,0,0,0,0,0,0,0,0,6,5,5,7,0,0,0,0,
0,0,0,0,0,0,0,0,0,0,0,0,0,0,0,0,0,0,0,0,0,0,0,0,0,0,0,0,0,0,0,0,0,0,0,0,0,0,0,0,0,0,0,0,0,0,0,0,17,0,
0,0,0,0,0,0,0,0,17,0,0,0,0,17,0,0,0,0,0,0,0,0,17,0,0,0,0,0,0,17,0,0,17,0,0,0,0,0,0,0,0,0,0,0,0,0,0,0,0,0,
0,0,0,0,0,17,0,0,0,0,0,0,0,0,0,0,0,0,0,0,0,0,0,0,0,0,17,0,0,0,0,0,0,0,0,0,17,0,0,0,0,0,0,0,0,0,0,0,0,0,
0,0,17,0,0,0,0,0,0,0,0,0,0,0,0,0,0,0,0,0,0,17,0,17,0,0,0,0,0,17,0,17,0,0,0,0,0,0,0,0,0,0,0,0,0,15,0,0,0,0,
0,0,0,0,0,0,0,0,0,0,0,0,0,0,0,17,0,0,0,0,0,0,0,0,0,0,0,0,0,0,0,0,0,17,0,0,0,0,0,0,0,0,0,0,0,0,0,0,0,0,
0,0,0,0,17,0,0,0,0,0,17,0,0,0,0,0,0,0,0,0,0,0,0,0,0,17,0,0,0,0,0,0,0,0,0,17,0,0,0,0,0,0,0,0,0,0,0,0,0,0,
0,0,0,0,0,0,0,0,0,0,0,0,0,17,0,0,0,0,0,0,0,17,0,0,0,0,0,0,0,0,17,0,17,0,0,0,0,0,0,17,0,0,0,0,0,0,0,0,0,0,
0,0,0,0,0,0,0,0,17,0,0,0,0,0,0,0,0,0,0,0,0,0,17,0,0,0,0,17,0,0,0,0,0,17,0,0,17,0,0,0,0,0,0,0,0,0,0,0,0,0,
0,0,0,0,0,0,0,0,0,0,0,0,0,0,0,0,0,0,0,0,0,0,0,0,0,0,0,0,0,0,0,0,0,0,0,0,0,0,0,0,0,0,0,0,0,0,0,0,0,0,
0,0,0,0,0,0,0,0,0,0,0,0,0,0,0,0,0,0,0,0,0,0,0,0,0,0,0,0,0,0,0,0,0,0,0,0,0,0,0,0,0,0,0,0,0,0,0,0,0,0,
0,0,0,0,0,0,0,0,0,0,0,0,0,0,0,0,0,0,0,0,0,0,0,0,0,0,0,0,0,0,0,0,0,0,0,0,0,0,0,0,0,0,0,0,0,0,0,0,0,0
END LAYER
END MAP
START PROPERTIES
Player,180,290
BackgroundMusic,SnowVillageBgm,audio/bgm/SnowVillageBgm.mp3
Portal,145,5,overWorld,245,465
Portal,185,395,snowVillageCave,155,45
Sign,125,25,Back to Overworld,50
Sign,375,285,Warning! Ice Wizard Congelus' residence ahead. No trespassing!,50
Sign,165,365,Beware! Beyond is a cave filled with danger!,50
ParticleEmitter,Snow,250,200,250,200,dark
Enemy,Congelus,445,355
END PROPERTIES
